2 4 6 8 10 12 14 15 18 20 22 24 26 28 30
2 3 6 8 10 12 14 15 18 20 22 23 26 27 30
1 4 6 8 10 11 14 16 18 19 22 24 25 28 30
1 4 6 8 10 12 13 16 18 20 22 24 26 28 30
1 4 6 8 10 11 13 16 18 20 22 24 26 28 30
1 3 6 8 10 12 14 15 18 20 22 24 26 28 30
1 3 5 8 10 12 14 16 18 20 22 24 26 28 30
1 4 5 8 10 12 14 16 17 20 22 24 26 27 30
1 3 6 8 10 12 14 16 18 20 21 23 26 28 30
1 4 6 8 10 12 13 15 18 20 22 24 26 28 30
2 4 6 8 10 12 13 15 18 20 22 23 26 28 30
1 3 6 8 10 11 14 16 18 20 21 24 26 28 30
2 4 5 8 9 12 14 16 18 20 22 24 26 28 30
2 4 6 7 10 12 13 16 18 20 22 24 26 28 29
1 3 5 8 10 12 14 16 18 19 21 23 26 28 30
1 3 6 8 10 12 14 16 18 20 21 24 26 28 30
1 3 6 8 10 11 14 15 18 20 21 24 26 27 29
1 3 5 8 10 12 14 15 18 20 22 24 26 27 30
2 3 6 8 10 11 13 16 18 20 22 24 26 28 30
2 3 5 8 9 11 14 15 18 20 22 24 26 28 29
1 4 6 8 10 12 13 15 18 19 22 24 26 28 29
1 4 6 8 10 12 14 16 18 20 22 23 26 28 30
0 4 5 8 10 12 14 16 18 20 22 24 26 27 30
1 3 5 8 10 12 14 16 18 20 21 23 26 28 30
0 3 6 8 9 12 14 16 18 20 21 23 25 28 30
2 3 6 8 10 12 14 15 18 19 22 24 26 28 30
2 3 6 8 10 12 14 15 18 20 22 24 26 28 29
1 3 6 8 10 12 14 15 18 20 22 24 26 27 30
2 4 6 8 10 12 14 15 18 20 22 24 26 28 29
2 3 5 8 10 12 14 16 18 20 22 24 26 28 30
2 4 6 8 10 12 14 15 18 20 22 24 26 28 29
2 4 6 8 10 12 14 15 18 20 22 24 26 28 30
1 4 6 8 10 12 13 15 18 20 22 24 25 27 29
1 4 6 8 10 12 14 16 18 20 22 24 25 28 30
2 4 6 8 9 12 14 15 18 20 22 24 26 28 29
1 4 6 8 10 12 14 16 18 20 22 23 25 28 29
1 3 6 8 10 12 14 16 17 20 22 24 26 28 29
1 3 6 8 10 12 14 16 18 20 22 23 26 27 30
1 3 5 8 10 12 14 16 18 20 21 24 26 28 30
0 3 5 8 10 11 13 16 18 20 22 24 26 28 30
1 3 6 8 10 12 13 16 17 19 22 24 26 27 29
2 4 6 8 10 12 14 15 18 20 22 24 26 28 30
1 4 6 8 9 12 14 15 18 20 22 24 26 28 29
1 4 6 8 10 11 13 16 18 20 22 24 26 28 30
1 4 5 8 10 12 14 16 18 19 21 24 26 28 30
1 4 6 8 10 12 13 15 18 20 22 24 26 28 29
1 4 6 8 10 12 14 15 18 20 22 24 26 28 29
2 4 6 8 10 12 13 16 18 20 22 24 26 28 30
2 4 6 8 10 12 14 16 18 20 22 23 26 28 30
2 4 6 8 10 12 14 16 18 20 22 24 26 27 29
2 4 6 8 10 11 14 16 18 20 22 24 26 27 30
1 4 5 8 10 11 14 16 18 19 21 23 25 27 30
0 3 6 8 10 12 13 15 18 20 22 24 26 28 30
1 4 6 8 9 12 14 16 18 20 21 23 25 27 29
1 3 5 8 10 11 14 16 18 20 22 24 26 27 30
1 3 5 7 10 12 14 16 17 20 22 24 26 27 30
1 3 6 8 9 12 14 15 18 20 22 24 26 28 29
1 4 5 8 10 12 14 16 18 20 22 24 26 28 30
0 4 5 8 10 12 14 16 17 20 22 23 25 27 30
1 3 6 8 10 12 14 16 18 20 21 24 26 28 30
1 3 5 7 9 11 13 15 18 20 22 24 26 27 29
2 3 6 8 10 12 14 16 18 20 21 24 26 28 30
1 4 6 8 9 12 14 15 18 20 22 24 26 28 29
1 3 6 8 10 12 14 16 18 20 21 24 26 28 30
1 4 6 8 10 11 13 16 18 20 22 24 26 28 30
2 3 6 8 10 12 14 15 18 20 22 24 26 28 29
1 3 6 8 10 11 14 16 18 20 22 24 26 28 30
1 4 5 8 10 11 14 15 18 20 22 23 26 27 30
1 4 5 8 10 12 14 16 18 20 22 24 25 28 30
2 4 6 8 10 12 13 16 18 20 22 24 26 28 30
2 3 5 8 9 12 14 16 18 20 22 24 26 28 30
1 3 5 8 10 12 14 16 18 20 22 24 26 28 30
1 4 6 8 10 11 14 16 18 20 22 24 26 28 29
1 3 6 8 10 12 14 16 18 20 22 23 26 27 30
2 3 6 8 10 12 14 16 18 20 22 23 26 28 30
1 4 6 8 10 12 13 16 18 20 22 24 26 28 30
1 3 6 8 10 12 14 16 18 20 21 23 26 27 29
1 3 6 8 10 12 14 16 18 20 22 24 25 28 30
1 3 6 8 9 11 14 16 18 20 22 24 26 28 30
1 3 5 8 9 11 14 15 18 20 22 24 26 27 29
1 4 5 8 10 12 14 15 18 20 22 24 26 28 30
1 3 6 8 10 11 14 15 18 19 22 24 26 28 30
1 3 6 8 10 12 14 16 18 20 21 24 26 28 30
1 3 5 7 10 12 14 16 18 20 22 24 26 27 30
2 4 5 8 10 12 14 16 18 20 22 24 26 28 30
1 3 6 8 9 12 14 15 18 20 22 24 26 27 29
2 3 6 8 10 12 14 16 18 20 21 24 26 28 30
1 4 6 8 10 12 13 16 18 20 22 24 26 28 29
1 4 6 8 10 12 14 15 17 20 22 24 26 27 30
1 4 6 8 10 11 14 16 17 20 22 24 26 27 30
2 3 6 8 9 12 13 15 18 20 22 24 26 28 29
1 3 6 8 9 12 14 16 18 20 22 23 26 28 30
2 3 5 8 9 12 14 16 18 20 22 24 26 27 29
1 4 5 8 10 12 14 16 18 20 22 24 26 28 29
1 3 6 8 10 12 14 15 18 20 22 23 26 28 30
2 3 6 8 10 12 13 15 18 20 22 24 26 28 30
1 4 6 8 10 11 14 16 18 20 22 24 26 28 30
1 3 5 8 9 12 13 16 18 20 22 24 26 28 29
2 4 6 8 9 12 14 15 18 20 22 24 26 28 29
1 4 6 8 10 12 13 16 18 20 22 24 26 28 30
1 3 6 8 10 11 14 16 18 20 22 23 26 27 29
1 4 6 8 10 12 13 16 18 20 22 24 26 28 30
1 4 5 8 10 11 14 16 18 20 22 24 26 28 30
0 4 5 8 9 12 14 16 18 19 22 24 26 28 30
2 3 6 8 10 12 14 16 18 20 21 24 26 28 30
2 4 6 8 9 12 14 16 18 20 22 24 26 28 30
1 4 5 8 10 12 14 16 18 20 22 24 26 28 30
1 4 6 8 10 12 14 16 18 20 21 23 26 28 30
1 3 6 8 10 11 14 15 18 20 22 24 26 28 30
0 3 6 8 10 12 13 16 18 20 22 23 26 28 30
0 4 6 8 10 12 14 16 18 20 22 24 26 28 30
1 4 5 8 10 12 14 16 18 20 21 24 26 28 30
1 4 5 8 9 12 14 16 18 20 22 24 26 28 30
2 4 6 8 9 12 13 15 18 20 22 24 26 28 29
2 4 6 8 10 11 13 16 17 20 22 24 26 28 29
1 3 5 8 10 12 14 16 18 20 22 24 26 28 30
1 4 6 8 10 12 14 16 17 20 22 24 26 27 30
1 4 6 8 10 11 13 16 18 20 22 24 26 28 30
2 4 6 8 10 12 14 15 18 20 22 24 26 28 30
0 3 6 8 10 11 14 16 18 20 22 24 26 28 30
2 4 6 8 10 12 14 16 18 20 21 23 25 28 30
0 4 5 8 10 12 13 16 18 20 21 23 25 28 29
2 3 6 8 10 12 14 16 18 20 21 24 26 28 30
1 3 6 8 10 12 14 15 18 20 22 24 26 28 30
2 3 5 8 10 12 14 16 18 20 22 24 26 27 30
1 4 6 8 10 11 14 16 18 20 22 24 26 28 29
2 3 6 8 10 12 13 16 18 20 22 24 26 28 30
2 4 5 8 10 12 14 16 18 20 22 24 26 28 29
0 4 5 8 9 11 14 16 18 20 22 24 26 27 30
1 4 6 8 10 11 13 16 18 20 22 24 26 28 30
1 4 5 8 10 11 14 15 18 20 21 23 25 27 29
2 4 6 8 10 11 13 16 18 20 22 24 26 28 30
1 3 6 8 10 12 14 16 18 20 22 24 26 27 30
1 3 6 8 10 12 14 16 18 20 22 24 26 27 30
2 4 6 8 10 12 14 16 18 20 22 23 25 28 30
1 3 5 8 9 12 14 16 18 20 22 24 26 28 30
0 4 5 8 10 12 14 16 18 20 22 24 25 28 30
2 3 6 8 10 12 14 15 18 20 22 24 26 28 30
1 3 5 8 9 12 14 16 17 20 22 24 26 27 30
1 3 6 8 9 12 14 16 18 20 22 23 26 28 30
1 4 6 8 10 12 13 16 18 20 22 24 26 28 30
1 4 5 8 10 12 14 16 18 20 22 23 25 28 30
1 3 6 8 9 12 14 16 18 20 21 23 25 27 30
2 3 6 8 10 12 14 15 18 20 22 24 26 28 30
1 4 5 8 10 11 14 16 18 20 22 23 25 27 29
1 4 6 8 10 11 13 16 18 20 22 23 26 27 30
2 4 6 8 10 12 14 15 18 20 22 24 26 28 29
1 3 5 8 10 11 14 16 18 20 22 23 26 27 30
1 3 5 8 10 12 14 16 18 20 22 24 26 28 30
2 3 6 8 9 11 14 16 18 20 22 24 26 28 30
1 3 5 8 10 12 14 16 18 20 22 24 26 28 30
2 4 6 8 10 12 13 15 18 20 22 24 26 28 30
0 4 5 7 10 12 13 16 18 20 22 24 26 28 30
2 4 6 8 9 12 14 16 18 20 22 24 26 28 30
1 3 6 8 10 11 13 15 18 20 22 24 26 28 29
2 4 6 8 10 12 14 15 18 20 22 24 26 28 29
2 4 5 8 10 12 14 16 18 20 22 24 26 28 29
1 4 6 8 10 12 14 15 18 20 22 24 26 28 29
2 4 6 8 10 12 14 16 18 20 22 24 26 27 29
2 3 5 8 10 12 14 15 18 20 22 24 26 27 29
1 3 6 8 10 12 13 15 18 20 22 24 26 28 29
2 3 6 8 10 12 14 16 18 20 22 24 26 28 29
2 4 5 8 9 12 14 16 18 20 22 24 26 28 30
1 3 6 8 9 12 13 16 18 20 22 24 26 28 29
2 3 6 8 9 12 14 15 18 20 22 24 26 27 29
2 4 6 8 10 12 13 15 18 20 22 24 26 28 29
1 3 6 8 10 12 14 16 18 20 22 23 26 27 30
1 3 6 8 9 11 14 16 18 20 22 24 26 27 29
2 4 6 8 10 12 14 15 18 20 22 24 26 28 29
1 3 6 8 10 12 14 16 17 19 22 23 25 27 30
1 4 5 8 10 12 14 16 18 20 22 23 25 28 30
1 4 6 8 10 12 13 16 18 20 22 24 26 28 29
1 4 6 8 10 12 13 16 18 20 22 24 26 28 29
1 3 6 8 10 11 14 15 18 20 22 24 26 27 29
2 3 6 8 10 12 14 16 17 20 22 24 26 28 30
1 3 6 8 10 12 13 15 18 20 22 24 26 28 29
2 3 5 8 10 12 13 15 18 20 22 24 26 27 30
1 3 5 8 10 12 14 15 18 20 22 24 26 28 30
1 4 6 8 10 11 13 16 18 20 22 24 26 28 30
1 3 6 8 10 11 13 15 18 20 22 23 26 28 29
1 3 6 8 10 12 14 16 18 20 22 23 26 28 30
1 4 6 8 10 12 13 16 18 19 21 23 25 28 30
1 3 6 8 9 12 14 16 18 20 21 23 26 27 30
2 3 6 8 10 11 13 15 18 20 22 24 26 28 29
1 3 6 8 10 12 14 15 18 20 22 24 26 28 30
1 3 6 8 10 12 13 15 18 20 22 24 26 28 30
1 3 5 8 9 12 14 16 17 20 22 24 26 27 30
2 4 6 8 10 12 14 15 18 20 22 24 26 28 29
1 3 6 8 10 12 14 16 17 20 22 24 26 28 30
1 4 6 8 10 11 13 16 18 20 22 24 26 28 30
0 3 6 8 10 12 14 15 18 20 22 23 26 27 30
1 4 5 8 10 12 14 16 18 20 22 24 26 28 30
1 3 5 8 9 11 14 16 18 20 22 24 26 27 30
1 4 6 8 10 12 14 16 18 20 22 24 26 28 29
1 3 5 8 10 12 14 16 18 19 22 24 26 28 30
1 3 5 8 10 12 14 16 18 20 22 24 26 28 30
2 4 5 8 9 11 14 15 18 20 22 24 26 27 29
0 3 6 8 10 12 14 16 18 20 22 23 26 28 30
1 4 5 8 9 11 13 15 18 20 22 24 26 27 29
1 3 6 8 10 11 14 15 17 20 22 24 26 27 29
1 3 5 8 10 12 14 16 18 20 22 24 26 28 30
2 4 6 8 10 12 14 15 18 20 22 24 26 28 29
1 3 6 8 9 12 14 16 18 19 22 24 25 28 30
2 4 6 8 10 12 14 15 18 20 22 24 26 28 29
0 3 6 8 10 12 14 16 18 20 22 23 26 28 30
2 4 6 8 9 12 14 15 18 20 22 24 26 27 29
1 4 6 8 9 12 14 16 18 20 22 24 26 28 30
1 3 5 8 10 12 14 16 18 20 22 24 26 28 30
0 3 5 7 9 12 14 15 17 20 22 24 25 27 29
0 3 5 8 10 12 14 16 18 20 22 24 26 28 30
1 3 5 8 10 12 14 16 18 20 22 24 26 28 29
2 3 6 8 9 12 14 15 18 20 22 24 26 28 29
1 3 5 8 10 12 14 16 18 20 22 24 26 27 30
2 3 6 8 10 12 14 16 18 20 22 24 26 28 29
1 4 5 8 10 12 14 16 18 20 22 24 26 28 30
2 3 6 8 10 11 13 16 18 20 22 24 26 27 29
2 4 5 8 10 11 14 15 18 20 22 24 26 28 30
1 3 5 8 10 12 13 16 17 20 22 24 26 27 29
0 3 6 8 10 12 13 15 18 19 22 24 26 28 29
1 4 6 8 9 11 13 15 18 19 22 24 26 27 29
1 4 6 8 10 11 14 16 18 20 22 24 26 28 30
2 4 5 8 10 11 14 16 18 20 22 24 26 28 30
0 4 5 8 10 12 14 16 18 20 22 23 26 28 29
1 4 6 8 9 11 13 16 18 20 22 24 26 28 29
2 4 6 8 10 12 14 15 18 20 22 24 26 28 29
1 4 5 8 9 12 14 16 18 20 22 24 26 27 30
1 4 6 8 10 12 14 16 18 20 22 24 25 28 30
1 4 6 8 9 11 13 16 18 20 22 23 26 28 30
0 4 5 8 9 11 14 16 18 20 22 24 26 27 30
1 4 6 8 10 11 13 16 18 20 22 24 26 28 30
1 4 6 8 10 12 14 16 18 20 22 24 25 28 30
1 3 6 8 10 12 14 16 18 20 21 24 26 28 30
1 4 5 8 9 12 14 16 18 20 22 24 26 28 30
2 4 6 8 10 12 14 15 18 20 22 24 26 27 29
1 3 5 8 10 11 13 16 18 20 21 23 26 28 30
2 4 6 8 9 11 13 15 18 20 22 24 26 27 29
2 4 6 8 10 12 14 15 18 20 22 24 26 27 29
1 3 6 8 10 12 13 15 18 20 22 24 26 28 30
2 4 6 8 9 12 14 16 18 20 22 24 26 28 30
1 4 6 8 10 12 14 16 18 20 22 24 25 28 30
1 3 6 8 9 12 14 16 18 20 21 24 26 28 30
2 4 6 8 10 12 14 16 18 20 22 24 26 28 29
2 4 6 8 9 12 14 15 17 20 22 23 26 27 30
2 4 6 8 10 12 14 16 18 20 22 24 26 27 29
2 4 6 8 9 11 14 15 18 20 22 24 26 27 29
1 4 6 8 9 11 13 16 18 20 22 24 26 28 30
1 3 6 8 10 12 13 16 18 20 22 24 26 28 30
1 3 6 8 10 12 14 16 18 20 21 24 26 28 30
1 3 5 8 10 12 14 16 18 20 22 24 26 28 30
1 4 6 8 10 11 14 16 18 20 22 24 26 28 30
1 4 6 8 10 12 14 16 18 20 21 23 26 28 30
1 3 6 8 9 11 14 16 18 20 22 24 26 27 29
2 3 6 8 10 12 14 16 18 20 21 24 26 28 30
1 4 6 8 10 12 14 16 17 20 22 24 26 28 30
0 3 6 8 9 12 14 16 18 20 22 24 26 28 30
2 3 6 8 9 12 14 16 18 20 22 23 26 28 30
2 4 6 8 10 12 13 15 18 20 22 24 26 28 30
1 4 6 8 10 11 13 15 18 20 22 24 26 28 29
2 3 6 8 9 12 14 15 18 20 22 24 26 27 29
2 4 6 8 10 11 14 15 18 20 22 23 26 27 30
1 3 5 8 10 12 14 16 18 19 22 24 26 28 30
1 4 6 8 10 12 13 16 18 20 22 24 26 28 30
1 4 6 8 10 12 13 15 18 20 22 24 26 27 29
2 4 6 8 9 12 14 15 18 20 22 24 26 27 29
1 4 6 8 10 12 13 16 18 20 22 24 26 28 30
2 3 6 8 10 12 13 16 18 20 22 24 26 28 29
1 3 6 8 10 12 13 15 18 20 22 24 26 27 30
1 3 5 8 9 12 14 16 18 20 22 24 26 28 30
1 4 6 8 10 12 14 15 18 20 22 23 26 27 30
2 4 6 8 10 12 14 15 18 20 22 24 26 28 30
2 4 6 8 10 12 14 15 18 20 22 24 26 28 30
1 3 6 8 10 12 14 15 18 20 22 24 26 28 29
2 3 6 8 10 12 13 15 18 20 22 24 26 28 29
1 3 5 8 10 12 14 16 18 20 22 24 26 28 30
0 3 6 8 10 12 14 16 18 20 21 24 26 28 30
2 3 6 8 10 11 13 15 18 20 22 24 26 28 29
1 4 6 8 10 11 13 16 18 20 22 23 26 28 30
1 4 6 8 9 12 14 16 18 20 22 24 26 27 29
1 4 6 8 10 12 13 16 18 20 22 24 26 28 29
1 3 6 8 10 12 14 16 18 20 21 24 26 28 30
1 4 6 8 10 12 14 16 18 20 22 24 25 28 30
2 4 6 8 10 11 13 16 18 20 22 24 26 28 29
2 4 6 8 10 12 14 16 18 20 22 24 26 27 30
1 3 6 8 10 12 14 16 18 20 22 24 26 28 29
1 4 6 8 10 12 14 16 18 20 22 24 25 28 30
1 4 6 8 10 12 13 15 18 20 22 23 26 27 29
1 4 5 7 10 12 13 15 18 20 22 24 25 28 30
2 4 6 8 9 12 14 16 18 20 22 24 26 28 30
2 4 5 8 9 12 14 16 18 20 22 23 26 28 30
1 3 5 8 10 12 14 16 18 20 22 24 26 28 30
2 3 6 8 10 12 14 16 17 20 22 24 26 27 29
1 4 6 8 9 12 13 15 18 20 22 24 26 28 29
1 3 5 8 10 12 14 16 18 20 22 24 26 28 30
2 4 6 8 10 11 13 16 18 20 22 24 26 28 30
1 3 6 8 9 12 14 15 18 20 22 23 25 27 30
1 4 6 8 9 12 14 15 18 20 22 24 26 27 29
1 4 6 8 10 12 14 16 18 20 22 24 25 28 30
1 3 5 8 10 12 14 16 18 20 22 24 26 28 30
1 4 6 8 10 12 13 16 18 19 22 24 26 28 30
1 3 6 8 10 12 14 15 18 20 22 24 26 28 30
1 3 6 8 10 11 13 16 18 20 22 24 26 27 29
1 4 5 8 10 12 14 16 18 19 22 24 26 28 30
1 4 6 8 10 12 14 16 18 20 21 24 26 28 30
2 3 6 8 10 12 14 16 18 20 21 24 26 28 30
1 4 6 8 10 12 13 15 18 20 22 24 26 28 30
1 3 6 8 9 11 14 16 18 20 22 24 26 27 29
1 3 5 8 10 12 14 16 18 20 22 24 26 28 30
1 3 6 8 10 12 14 16 18 19 22 24 26 28 30
1 4 6 8 10 12 14 15 18 20 22 24 26 28 30
1 3 6 8 9 12 14 16 18 20 21 23 25 27 30
2 3 6 8 10 12 14 16 18 20 21 23 26 28 30
2 4 6 8 10 12 14 16 18 20 22 24 26 28 29
1 4 5 8 9 12 13 15 18 20 22 24 26 28 29
1 4 6 8 10 12 14 16 18 20 22 23 26 28 30
2 3 6 8 10 12 14 16 18 20 21 24 26 28 30
2 4 6 8 9 12 14 16 18 20 22 24 26 27 29
1 4 6 8 9 12 13 15 18 20 22 24 26 27 30
2 4 6 8 10 12 14 16 18 20 22 24 26 28 29
2 4 6 8 10 12 13 16 18 20 22 24 26 28 30
1 4 6 8 10 12 13 15 18 20 22 24 26 28 29
1 3 6 8 10 12 13 16 18 20 22 24 26 28 30
1 4 6 8 10 12 14 16 18 20 22 23 26 28 30
2 4 6 8 10 12 14 15 18 20 22 24 26 28 29
1 3 6 8 9 12 13 15 18 20 22 24 26 27 29
2 3 6 8 10 12 14 15 18 20 22 24 26 27 29
2 3 6 8 10 11 13 16 18 20 21 24 26 27 29
1 3 5 8 10 12 14 16 18 20 22 24 26 27 30
2 4 6 8 9 11 13 16 18 20 22 24 26 28 29
1 3 6 8 10 12 14 16 18 20 21 24 26 28 30
1 4 6 8 10 12 13 16 18 20 22 24 26 28 29
1 3 5 8 10 12 14 16 18 20 21 23 26 27 30
1 4 6 8 10 12 13 16 18 20 22 24 26 28 30
1 3 5 8 10 12 14 16 18 19 22 24 25 28 30
1 4 6 8 10 11 13 16 18 20 22 24 26 28 30
1 4 5 8 9 11 13 15 17 20 22 24 26 28 29
1 4 6 8 10 11 13 16 18 20 22 24 26 28 30 0