2 6 10 14 18 22 26 29 34 38 42 46 50 54 58
2 5 10 14 18 22 26 29 34 38 42 45 50 53 58
1 6 10 14 18 21 26 30 34 37 42 46 49 54 58
1 6 10 14 18 22 25 30 34 38 42 46 50 54 58
1 6 10 14 18 21 25 30 34 38 42 46 50 54 58
1 5 10 14 18 22 26 29 34 38 42 46 50 54 58
1 5 9 14 18 22 26 30 34 38 42 46 50 54 58
1 6 9 14 18 22 26 30 33 38 42 46 50 53 58
1 5 10 14 18 22 26 30 34 38 41 45 50 54 58
1 6 10 14 18 22 25 29 34 38 42 46 50 54 58
2 6 10 14 18 22 25 29 34 38 42 45 50 54 58
1 5 10 14 18 21 26 30 34 38 41 46 50 54 58
2 6 9 14 17 22 26 30 34 38 42 46 50 54 58
2 6 10 13 18 22 25 30 34 38 42 46 50 54 57
1 5 9 14 18 22 26 30 34 37 41 45 50 54 58
1 5 10 14 18 22 26 30 34 38 41 46 50 54 58
1 5 10 14 18 21 26 29 34 38 41 46 50 53 57
1 5 9 14 18 22 26 29 34 38 42 46 50 53 58
2 5 10 14 18 21 25 30 34 38 42 46 50 54 58
2 5 9 14 17 21 26 29 34 38 42 46 50 54 57
1 6 10 14 18 22 25 29 34 37 42 46 50 54 57
1 6 10 14 18 22 26 30 34 38 42 45 50 54 58
0 6 9 14 18 22 26 30 34 38 42 46 50 53 58
1 5 9 14 18 22 26 30 34 38 41 45 50 54 58
0 5 10 14 17 22 26 30 34 38 41 45 49 54 58
2 5 10 14 18 22 26 29 34 37 42 46 50 54 58
2 5 10 14 18 22 26 29 34 38 42 46 50 54 57
1 5 10 14 18 22 26 29 34 38 42 46 50 53 58
2 6 10 14 18 22 26 29 34 38 42 46 50 54 57
2 5 9 14 18 22 26 30 34 38 42 46 50 54 58
2 6 10 14 18 22 26 29 34 38 42 46 50 54 57
2 6 10 14 18 22 26 29 34 38 42 46 50 54 58
1 6 10 14 18 22 25 29 34 38 42 46 49 53 57
1 6 10 14 18 22 26 30 34 38 42 46 49 54 58
2 6 10 14 17 22 26 29 34 38 42 46 50 54 57
1 6 10 14 18 22 26 30 34 38 42 45 49 54 57
1 5 10 14 18 22 26 30 33 38 42 46 50 54 57
1 5 10 14 18 22 26 30 34 38 42 45 50 53 58
1 5 9 14 18 22 26 30 34 38 41 46 50 54 58
0 5 9 14 18 21 25 30 34 38 42 46 50 54 58
1 5 10 14 18 22 25 30 33 37 42 46 50 53 57
2 6 10 14 18 22 26 29 34 38 42 46 50 54 58
1 6 10 14 17 22 26 29 34 38 42 46 50 54 57
1 6 10 14 18 21 25 30 34 38 42 46 50 54 58
1 6 9 14 18 22 26 30 34 37 41 46 50 54 58
1 6 10 14 18 22 25 29 34 38 42 46 50 54 57
1 6 10 14 18 22 26 29 34 38 42 46 50 54 57
2 6 10 14 18 22 25 30 34 38 42 46 50 54 58
2 6 10 14 18 22 26 30 34 38 42 45 50 54 58
2 6 10 14 18 22 26 30 34 38 42 46 50 53 57
2 6 10 14 18 21 26 30 34 38 42 46 50 53 58
1 6 9 14 18 21 26 30 34 37 41 45 49 53 58
0 5 10 14 18 22 25 29 34 38 42 46 50 54 58
1 6 10 14 17 22 26 30 34 38 41 45 49 53 57
1 5 9 14 18 21 26 30 34 38 42 46 50 53 58
1 5 9 13 18 22 26 30 33 38 42 46 50 53 58
1 5 10 14 17 22 26 29 34 38 42 46 50 54 57
1 6 9 14 18 22 26 30 34 38 42 46 50 54 58
0 6 9 14 18 22 26 30 33 38 42 45 49 53 58
1 5 10 14 18 22 26 30 34 38 41 46 50 54 58
1 5 9 13 17 21 25 29 34 38 42 46 50 53 57
2 5 10 14 18 22 26 30 34 38 41 46 50 54 58
1 6 10 14 17 22 26 29 34 38 42 46 50 54 57
1 5 10 14 18 22 26 30 34 38 41 46 50 54 58
1 6 10 14 18 21 25 30 34 38 42 46 50 54 58
2 5 10 14 18 22 26 29 34 38 42 46 50 54 57
1 5 10 14 18 21 26 30 34 38 42 46 50 54 58
1 6 9 14 18 21 26 29 34 38 42 45 50 53 58
1 6 9 14 18 22 26 30 34 38 42 46 49 54 58
2 6 10 14 18 22 25 30 34 38 42 46 50 54 58
2 5 9 14 17 22 26 30 34 38 42 46 50 54 58
1 5 9 14 18 22 26 30 34 38 42 46 50 54 58
1 6 10 14 18 21 26 30 34 38 42 46 50 54 57
1 5 10 14 18 22 26 30 34 38 42 45 50 53 58
2 5 10 14 18 22 26 30 34 38 42 45 50 54 58
1 6 10 14 18 22 25 30 34 38 42 46 50 54 58
1 5 10 14 18 22 26 30 34 38 41 45 50 53 57
1 5 10 14 18 22 26 30 34 38 42 46 49 54 58
1 5 10 14 17 21 26 30 34 38 42 46 50 54 58
1 5 9 14 17 21 26 29 34 38 42 46 50 53 57
1 6 9 14 18 22 26 29 34 38 42 46 50 54 58
1 5 10 14 18 21 26 29 34 37 42 46 50 54 58
1 5 10 14 18 22 26 30 34 38 41 46 50 54 58
1 5 9 13 18 22 26 30 34 38 42 46 50 53 58
2 6 9 14 18 22 26 30 34 38 42 46 50 54 58
1 5 10 14 17 22 26 29 34 38 42 46 50 53 57
2 5 10 14 18 22 26 30 34 38 41 46 50 54 58
1 6 10 14 18 22 25 30 34 38 42 46 50 54 57
1 6 10 14 18 22 26 29 33 38 42 46 50 53 58
1 6 10 14 18 21 26 30 33 38 42 46 50 53 58
2 5 10 14 17 22 25 29 34 38 42 46 50 54 57
1 5 10 14 17 22 26 30 34 38 42 45 50 54 58
2 5 9 14 17 22 26 30 34 38 42 46 50 53 57
1 6 9 14 18 22 26 30 34 38 42 46 50 54 57
1 5 10 14 18 22 26 29 34 38 42 45 50 54 58
2 5 10 14 18 22 25 29 34 38 42 46 50 54 58
1 6 10 14 18 21 26 30 34 38 42 46 50 54 58
1 5 9 14 17 22 25 30 34 38 42 46 50 54 57
2 6 10 14 17 22 26 29 34 38 42 46 50 54 57
1 6 10 14 18 22 25 30 34 38 42 46 50 54 58
1 5 10 14 18 21 26 30 34 38 42 45 50 53 57
1 6 10 14 18 22 25 30 34 38 42 46 50 54 58
1 6 9 14 18 21 26 30 34 38 42 46 50 54 58
0 6 9 14 17 22 26 30 34 37 42 46 50 54 58
2 5 10 14 18 22 26 30 34 38 41 46 50 54 58
2 6 10 14 17 22 26 30 34 38 42 46 50 54 58
1 6 9 14 18 22 26 30 34 38 42 46 50 54 58
1 6 10 14 18 22 26 30 34 38 41 45 50 54 58
1 5 10 14 18 21 26 29 34 38 42 46 50 54 58
0 5 10 14 18 22 25 30 34 38 42 45 50 54 58
0 6 10 14 18 22 26 30 34 38 42 46 50 54 58
1 6 9 14 18 22 26 30 34 38 41 46 50 54 58
1 6 9 14 17 22 26 30 34 38 42 46 50 54 58
2 6 10 14 17 22 25 29 34 38 42 46 50 54 57
2 6 10 14 18 21 25 30 33 38 42 46 50 54 57
1 5 9 14 18 22 26 30 34 38 42 46 50 54 58
1 6 10 14 18 22 26 30 33 38 42 46 50 53 58
1 6 10 14 18 21 25 30 34 38 42 46 50 54 58
2 6 10 14 18 22 26 29 34 38 42 46 50 54 58
0 5 10 14 18 21 26 30 34 38 42 46 50 54 58
2 6 10 14 18 22 26 30 34 38 41 45 49 54 58
0 6 9 14 18 22 25 30 34 38 41 45 49 54 57
2 5 10 14 18 22 26 30 34 38 41 46 50 54 58
1 5 10 14 18 22 26 29 34 38 42 46 50 54 58
2 5 9 14 18 22 26 30 34 38 42 46 50 53 58
1 6 10 14 18 21 26 30 34 38 42 46 50 54 57
2 5 10 14 18 22 25 30 34 38 42 46 50 54 58
2 6 9 14 18 22 26 30 34 38 42 46 50 54 57
0 6 9 14 17 21 26 30 34 38 42 46 50 53 58
1 6 10 14 18 21 25 30 34 38 42 46 50 54 58
1 6 9 14 18 21 26 29 34 38 41 45 49 53 57
2 6 10 14 18 21 25 30 34 38 42 46 50 54 58
1 5 10 14 18 22 26 30 34 38 42 46 50 53 58
1 5 10 14 18 22 26 30 34 38 42 46 50 53 58
2 6 10 14 18 22 26 30 34 38 42 45 49 54 58
1 5 9 14 17 22 26 30 34 38 42 46 50 54 58
0 6 9 14 18 22 26 30 34 38 42 46 49 54 58
2 5 10 14 18 22 26 29 34 38 42 46 50 54 58
1 5 9 14 17 22 26 30 33 38 42 46 50 53 58
1 5 10 14 17 22 26 30 34 38 42 45 50 54 58
1 6 10 14 18 22 25 30 34 38 42 46 50 54 58
1 6 9 14 18 22 26 30 34 38 42 45 49 54 58
1 5 10 14 17 22 26 30 34 38 41 45 49 53 58
2 5 10 14 18 22 26 29 34 38 42 46 50 54 58
1 6 9 14 18 21 26 30 34 38 42 45 49 53 57
1 6 10 14 18 21 25 30 34 38 42 45 50 53 58
2 6 10 14 18 22 26 29 34 38 42 46 50 54 57
1 5 9 14 18 21 26 30 34 38 42 45 50 53 58
1 5 9 14 18 22 26 30 34 38 42 46 50 54 58
2 5 10 14 17 21 26 30 34 38 42 46 50 54 58
1 5 9 14 18 22 26 30 34 38 42 46 50 54 58
2 6 10 14 18 22 25 29 34 38 42 46 50 54 58
0 6 9 13 18 22 25 30 34 38 42 46 50 54 58
2 6 10 14 17 22 26 30 34 38 42 46 50 54 58
1 5 10 14 18 21 25 29 34 38 42 46 50 54 57
2 6 10 14 18 22 26 29 34 38 42 46 50 54 57
2 6 9 14 18 22 26 30 34 38 42 46 50 54 57
1 6 10 14 18 22 26 29 34 38 42 46 50 54 57
2 6 10 14 18 22 26 30 34 38 42 46 50 53 57
2 5 9 14 18 22 26 29 34 38 42 46 50 53 57
1 5 10 14 18 22 25 29 34 38 42 46 50 54 57
2 5 10 14 18 22 26 30 34 38 42 46 50 54 57
2 6 9 14 17 22 26 30 34 38 42 46 50 54 58
1 5 10 14 17 22 25 30 34 38 42 46 50 54 57
2 5 10 14 17 22 26 29 34 38 42 46 50 53 57
2 6 10 14 18 22 25 29 34 38 42 46 50 54 57
1 5 10 14 18 22 26 30 34 38 42 45 50 53 58
1 5 10 14 17 21 26 30 34 38 42 46 50 53 57
2 6 10 14 18 22 26 29 34 38 42 46 50 54 57
1 5 10 14 18 22 26 30 33 37 42 45 49 53 58
1 6 9 14 18 22 26 30 34 38 42 45 49 54 58
1 6 10 14 18 22 25 30 34 38 42 46 50 54 57
1 6 10 14 18 22 25 30 34 38 42 46 50 54 57
1 5 10 14 18 21 26 29 34 38 42 46 50 53 57
2 5 10 14 18 22 26 30 33 38 42 46 50 54 58
1 5 10 14 18 22 25 29 34 38 42 46 50 54 57
2 5 9 14 18 22 25 29 34 38 42 46 50 53 58
1 5 9 14 18 22 26 29 34 38 42 46 50 54 58
1 6 10 14 18 21 25 30 34 38 42 46 50 54 58
1 5 10 14 18 21 25 29 34 38 42 45 50 54 57
1 5 10 14 18 22 26 30 34 38 42 45 50 54 58
1 6 10 14 18 22 25 30 34 37 41 45 49 54 58
1 5 10 14 17 22 26 30 34 38 41 45 50 53 58
2 5 10 14 18 21 25 29 34 38 42 46 50 54 57
1 5 10 14 18 22 26 29 34 38 42 46 50 54 58
1 5 10 14 18 22 25 29 34 38 42 46 50 54 58
1 5 9 14 17 22 26 30 33 38 42 46 50 53 58
2 6 10 14 18 22 26 29 34 38 42 46 50 54 57
1 5 10 14 18 22 26 30 33 38 42 46 50 54 58
1 6 10 14 18 21 25 30 34 38 42 46 50 54 58
0 5 10 14 18 22 26 29 34 38 42 45 50 53 58
1 6 9 14 18 22 26 30 34 38 42 46 50 54 58
1 5 9 14 17 21 26 30 34 38 42 46 50 53 58
1 6 10 14 18 22 26 30 34 38 42 46 50 54 57
1 5 9 14 18 22 26 30 34 37 42 46 50 54 58
1 5 9 14 18 22 26 30 34 38 42 46 50 54 58
2 6 9 14 17 21 26 29 34 38 42 46 50 53 57
0 5 10 14 18 22 26 30 34 38 42 45 50 54 58
1 6 9 14 17 21 25 29 34 38 42 46 50 53 57
1 5 10 14 18 21 26 29 33 38 42 46 50 53 57
1 5 9 14 18 22 26 30 34 38 42 46 50 54 58
2 6 10 14 18 22 26 29 34 38 42 46 50 54 57
1 5 10 14 17 22 26 30 34 37 42 46 49 54 58
2 6 10 14 18 22 26 29 34 38 42 46 50 54 57
0 5 10 14 18 22 26 30 34 38 42 45 50 54 58
2 6 10 14 17 22 26 29 34 38 42 46 50 53 57
1 6 10 14 17 22 26 30 34 38 42 46 50 54 58
1 5 9 14 18 22 26 30 34 38 42 46 50 54 58
0 5 9 13 17 22 26 29 33 38 42 46 49 53 57
0 5 9 14 18 22 26 30 34 38 42 46 50 54 58
1 5 9 14 18 22 26 30 34 38 42 46 50 54 57
2 5 10 14 17 22 26 29 34 38 42 46 50 54 57
1 5 9 14 18 22 26 30 34 38 42 46 50 53 58
2 5 10 14 18 22 26 30 34 38 42 46 50 54 57
1 6 9 14 18 22 26 30 34 38 42 46 50 54 58
2 5 10 14 18 21 25 30 34 38 42 46 50 53 57
2 6 9 14 18 21 26 29 34 38 42 46 50 54 58
1 5 9 14 18 22 25 30 33 38 42 46 50 53 57
0 5 10 14 18 22 25 29 34 37 42 46 50 54 57
1 6 10 14 17 21 25 29 34 37 42 46 50 53 57
1 6 10 14 18 21 26 30 34 38 42 46 50 54 58
2 6 9 14 18 21 26 30 34 38 42 46 50 54 58
0 6 9 14 18 22 26 30 34 38 42 45 50 54 57
1 6 10 14 17 21 25 30 34 38 42 46 50 54 57
2 6 10 14 18 22 26 29 34 38 42 46 50 54 57
1 6 9 14 17 22 26 30 34 38 42 46 50 53 58
1 6 10 14 18 22 26 30 34 38 42 46 49 54 58
1 6 10 14 17 21 25 30 34 38 42 45 50 54 58
0 6 9 14 17 21 26 30 34 38 42 46 50 53 58
1 6 10 14 18 21 25 30 34 38 42 46 50 54 58
1 6 10 14 18 22 26 30 34 38 42 46 49 54 58
1 5 10 14 18 22 26 30 34 38 41 46 50 54 58
1 6 9 14 17 22 26 30 34 38 42 46 50 54 58
2 6 10 14 18 22 26 29 34 38 42 46 50 53 57
1 5 9 14 18 21 25 30 34 38 41 45 50 54 58
2 6 10 14 17 21 25 29 34 38 42 46 50 53 57
2 6 10 14 18 22 26 29 34 38 42 46 50 53 57
1 5 10 14 18 22 25 29 34 38 42 46 50 54 58
2 6 10 14 17 22 26 30 34 38 42 46 50 54 58
1 6 10 14 18 22 26 30 34 38 42 46 49 54 58
1 5 10 14 17 22 26 30 34 38 41 46 50 54 58
2 6 10 14 18 22 26 30 34 38 42 46 50 54 57
2 6 10 14 17 22 26 29 33 38 42 45 50 53 58
2 6 10 14 18 22 26 30 34 38 42 46 50 53 57
2 6 10 14 17 21 26 29 34 38 42 46 50 53 57
1 6 10 14 17 21 25 30 34 38 42 46 50 54 58
1 5 10 14 18 22 25 30 34 38 42 46 50 54 58
1 5 10 14 18 22 26 30 34 38 41 46 50 54 58
1 5 9 14 18 22 26 30 34 38 42 46 50 54 58
1 6 10 14 18 21 26 30 34 38 42 46 50 54 58
1 6 10 14 18 22 26 30 34 38 41 45 50 54 58
1 5 10 14 17 21 26 30 34 38 42 46 50 53 57
2 5 10 14 18 22 26 30 34 38 41 46 50 54 58
1 6 10 14 18 22 26 30 33 38 42 46 50 54 58
0 5 10 14 17 22 26 30 34 38 42 46 50 54 58
2 5 10 14 17 22 26 30 34 38 42 45 50 54 58
2 6 10 14 18 22 25 29 34 38 42 46 50 54 58
1 6 10 14 18 21 25 29 34 38 42 46 50 54 57
2 5 10 14 17 22 26 29 34 38 42 46 50 53 57
2 6 10 14 18 21 26 29 34 38 42 45 50 53 58
1 5 9 14 18 22 26 30 34 37 42 46 50 54 58
1 6 10 14 18 22 25 30 34 38 42 46 50 54 58
1 6 10 14 18 22 25 29 34 38 42 46 50 53 57
2 6 10 14 17 22 26 29 34 38 42 46 50 53 57
1 6 10 14 18 22 25 30 34 38 42 46 50 54 58
2 5 10 14 18 22 25 30 34 38 42 46 50 54 57
1 5 10 14 18 22 25 29 34 38 42 46 50 53 58
1 5 9 14 17 22 26 30 34 38 42 46 50 54 58
1 6 10 14 18 22 26 29 34 38 42 45 50 53 58
2 6 10 14 18 22 26 29 34 38 42 46 50 54 58
2 6 10 14 18 22 26 29 34 38 42 46 50 54 58
1 5 10 14 18 22 26 29 34 38 42 46 50 54 57
2 5 10 14 18 22 25 29 34 38 42 46 50 54 57
1 5 9 14 18 22 26 30 34 38 42 46 50 54 58
0 5 10 14 18 22 26 30 34 38 41 46 50 54 58
2 5 10 14 18 21 25 29 34 38 42 46 50 54 57
1 6 10 14 18 21 25 30 34 38 42 45 50 54 58
1 6 10 14 17 22 26 30 34 38 42 46 50 53 57
1 6 10 14 18 22 25 30 34 38 42 46 50 54 57
1 5 10 14 18 22 26 30 34 38 41 46 50 54 58
1 6 10 14 18 22 26 30 34 38 42 46 49 54 58
2 6 10 14 18 21 25 30 34 38 42 46 50 54 57
2 6 10 14 18 22 26 30 34 38 42 46 50 53 58
1 5 10 14 18 22 26 30 34 38 42 46 50 54 57
1 6 10 14 18 22 26 30 34 38 42 46 49 54 58
1 6 10 14 18 22 25 29 34 38 42 45 50 53 57
1 6 9 13 18 22 25 29 34 38 42 46 49 54 58
2 6 10 14 17 22 26 30 34 38 42 46 50 54 58
2 6 9 14 17 22 26 30 34 38 42 45 50 54 58
1 5 9 14 18 22 26 30 34 38 42 46 50 54 58
2 5 10 14 18 22 26 30 33 38 42 46 50 53 57
1 6 10 14 17 22 25 29 34 38 42 46 50 54 57
1 5 9 14 18 22 26 30 34 38 42 46 50 54 58
2 6 10 14 18 21 25 30 34 38 42 46 50 54 58
1 5 10 14 17 22 26 29 34 38 42 45 49 53 58
1 6 10 14 17 22 26 29 34 38 42 46 50 53 57
1 6 10 14 18 22 26 30 34 38 42 46 49 54 58
1 5 9 14 18 22 26 30 34 38 42 46 50 54 58
1 6 10 14 18 22 25 30 34 37 42 46 50 54 58
1 5 10 14 18 22 26 29 34 38 42 46 50 54 58
1 5 10 14 18 21 25 30 34 38 42 46 50 53 57
1 6 9 14 18 22 26 30 34 37 42 46 50 54 58
1 6 10 14 18 22 26 30 34 38 41 46 50 54 58
2 5 10 14 18 22 26 30 34 38 41 46 50 54 58
1 6 10 14 18 22 25 29 34 38 42 46 50 54 58
1 5 10 14 17 21 26 30 34 38 42 46 50 53 57
1 5 9 14 18 22 26 30 34 38 42 46 50 54 58
1 5 10 14 18 22 26 30 34 37 42 46 50 54 58
1 6 10 14 18 22 26 29 34 38 42 46 50 54 58
1 5 10 14 17 22 26 30 34 38 41 45 49 53 58
2 5 10 14 18 22 26 30 34 38 41 45 50 54 58
2 6 10 14 18 22 26 30 34 38 42 46 50 54 57
1 6 9 14 17 22 25 29 34 38 42 46 50 54 57
1 6 10 14 18 22 26 30 34 38 42 45 50 54 58
2 5 10 14 18 22 26 30 34 38 41 46 50 54 58
2 6 10 14 17 22 26 30 34 38 42 46 50 53 57
1 6 10 14 17 22 25 29 34 38 42 46 50 53 58
2 6 10 14 18 22 26 30 34 38 42 46 50 54 57
2 6 10 14 18 22 25 30 34 38 42 46 50 54 58
1 6 10 14 18 22 25 29 34 38 42 46 50 54 57
1 5 10 14 18 22 25 30 34 38 42 46 50 54 58
1 6 10 14 18 22 26 30 34 38 42 45 50 54 58
2 6 10 14 18 22 26 29 34 38 42 46 50 54 57
1 5 10 14 17 22 25 29 34 38 42 46 50 53 57
2 5 10 14 18 22 26 29 34 38 42 46 50 53 57
2 5 10 14 18 21 25 30 34 38 41 46 50 53 57
1 5 9 14 18 22 26 30 34 38 42 46 50 53 58
2 6 10 14 17 21 25 30 34 38 42 46 50 54 57
1 5 10 14 18 22 26 30 34 38 41 46 50 54 58
1 6 10 14 18 22 25 30 34 38 42 46 50 54 57
1 5 9 14 18 22 26 30 34 38 41 45 50 53 58
1 6 10 14 18 22 25 30 34 38 42 46 50 54 58
1 5 9 14 18 22 26 30 34 37 42 46 49 54 58
1 6 10 14 18 21 25 30 34 38 42 46 50 54 58
1 6 9 14 17 21 25 29 33 38 42 46 50 54 57
1 6 10 14 18 21 25 30 34 38 42 46 50 54 58 30
