1 4 8 13 16 20 25 29 33 37 40 44 50 56 60 65
1 4 8 13 16 20 24 29 33 37 40 44 50 57 60 65
0 4 9 12 16 21 25 29 33 36 40 45 48 57 60 64
1 4 8 13 16 20 25 29 33 37 40 44 50 56 60 65
1 4 8 13 16 20 25 29 33 37 40 44 50 57 60 65
1 4 8 13 16 20 24 29 33 37 40 44 50 57 60 65
1 4 8 13 16 20 24 29 33 37 40 44 50 57 61 65
0 4 9 12 16 21 24 29 33 36 40 45 48 57 61 64
0 4 9 12 16 21 25 29 33 36 40 45 48 57 60 64
1 4 8 13 16 20 24 29 33 37 40 44 50 56 61 64
1 4 8 13 16 20 25 29 33 37 40 44 50 57 60 65
0 5 9 12 17 20 24 28 33 37 40 44 49 57 61 64
0 4 9 12 16 21 25 29 33 36 40 45 48 57 60 64
0 4 9 12 16 20 25 28 32 36 40 44 48 56 60 64
0 4 9 12 16 21 25 28 32 36 40 44 50 56 60 64
0 4 9 12 16 21 25 28 32 36 40 44 52 56 60 64
0 5 9 12 17 20 25 28 33 37 40 44 49 57 60 64
1 4 8 13 16 20 24 29 33 37 40 44 50 57 60 65
0 4 9 12 16 21 25 29 33 36 40 45 48 57 60 65
0 4 8 13 16 21 25 29 33 37 40 45 48 57 60 65
0 5 9 12 17 20 24 28 33 37 40 44 49 57 61 64
0 5 9 12 17 21 24 28 33 37 40 44 49 57 60 64
1 4 8 13 16 20 24 29 33 37 40 44 50 57 60 65
0 5 9 12 17 20 24 28 33 37 40 44 49 57 60 65
0 4 9 12 16 20 24 28 32 37 40 44 52 56 60 64
0 4 9 12 16 21 25 29 33 37 40 44 50 56 60 64
0 4 9 12 16 21 25 29 33 37 41 44 50 56 60 64
1 4 8 13 17 20 24 29 33 37 40 44 49 57 60 64
1 4 8 13 16 20 24 29 33 37 40 44 50 57 60 65
1 4 8 13 16 20 25 29 33 37 40 44 49 56 61 65
0 4 9 12 17 20 24 28 32 37 40 44 52 56 60 64
1 4 8 13 16 20 24 29 33 37 40 44 50 57 61 65
1 4 8 13 16 20 24 29 33 37 40 44 49 56 60 65
0 5 9 12 17 21 25 28 33 37 40 44 49 57 60 64
0 4 9 12 16 21 24 29 33 36 40 45 48 57 60 64
1 4 8 13 16 20 24 29 33 37 40 44 50 57 61 64
1 4 8 13 16 20 24 29 33 37 40 44 50 57 60 64
0 5 9 12 17 20 25 28 33 37 40 44 49 57 60 64
0 4 9 12 16 21 25 29 33 36 40 45 48 57 60 64
1 4 9 12 17 20 24 28 32 37 41 44 52 56 61 64
1 4 9 12 17 20 24 28 32 37 40 44 52 56 60 64
0 5 9 12 16 20 25 28 33 37 40 44 49 57 60 64
0 4 9 12 17 20 25 28 32 37 40 44 52 56 60 64
0 5 9 12 17 20 24 28 33 37 40 44 49 57 60 64
1 4 8 13 16 20 25 29 33 37 40 44 50 57 60 65
1 4 8 13 16 20 25 29 33 37 40 44 50 57 60 65
0 4 9 12 16 21 25 28 32 36 40 44 52 56 60 64
1 4 8 13 16 20 25 29 33 37 40 44 50 57 60 65
1 4 8 13 16 21 25 29 33 37 40 44 50 57 60 65
1 4 8 13 16 20 25 29 33 37 40 44 50 57 60 64
1 4 8 13 16 20 25 29 33 37 40 44 50 57 60 65
1 4 9 12 17 20 24 28 32 37 40 44 52 56 60 64
0 4 9 12 16 21 25 29 33 37 40 44 50 57 60 64
0 4 9 12 16 21 25 28 32 36 40 44 53 56 60 65
1 4 8 13 16 20 25 29 33 37 40 44 50 57 60 64
1 4 8 13 16 20 24 29 33 37 40 44 50 57 60 65
0 5 9 12 16 20 24 28 33 37 40 44 49 57 60 65
0 5 9 12 17 20 24 28 33 37 40 44 49 57 61 64
0 5 9 12 16 21 25 28 33 37 40 44 49 57 60 65
0 5 9 12 17 20 24 28 33 37 40 44 49 57 60 64
0 4 9 12 16 21 25 29 33 36 40 45 48 57 60 65
0 4 9 12 16 21 25 29 33 36 40 45 48 57 60 64
0 4 9 12 16 20 25 29 33 37 41 44 48 57 60 64
1 4 9 13 16 21 25 28 33 37 40 44 50 57 60 65
1 4 8 13 16 20 25 29 33 37 40 44 50 57 60 65
1 4 8 13 16 20 24 29 33 37 40 44 50 57 61 65
0 4 8 13 16 21 25 29 33 37 40 45 48 57 60 65
1 4 8 13 16 20 25 29 33 37 40 44 50 57 60 65
1 4 8 13 16 20 25 29 33 37 40 44 50 57 61 65
1 4 8 13 16 20 25 29 33 37 40 44 50 57 60 65
1 4 8 13 16 20 24 29 33 37 40 44 50 57 61 65
0 5 9 12 16 20 25 28 33 37 40 44 49 57 60 65
0 4 8 12 16 20 25 28 32 37 41 44 53 57 60 64
0 4 9 12 16 21 24 29 33 36 40 45 48 57 60 64
1 4 8 13 16 21 25 29 33 37 40 45 48 56 60 65
1 4 8 13 16 21 25 29 33 37 40 45 49 57 60 65
0 4 8 12 16 21 25 29 33 36 41 44 48 57 60 64
0 4 9 12 16 21 25 28 32 36 41 44 48 56 60 64
0 5 9 12 17 21 25 28 33 37 40 44 49 57 60 64
0 5 9 12 17 21 25 28 33 37 40 44 49 57 60 64
0 4 9 12 16 20 25 29 33 37 40 44 48 57 60 64
0 4 9 12 16 20 24 28 32 37 40 44 48 56 60 64
0 4 9 12 16 21 24 29 33 36 40 45 48 57 60 64
0 5 9 12 17 20 24 28 33 37 40 44 49 57 60 64
1 4 8 13 16 20 24 29 33 37 40 44 49 57 60 64
0 4 9 12 16 21 25 28 32 36 40 44 51 56 60 64
0 4 9 12 16 21 25 29 33 36 41 45 48 57 60 65
0 5 9 12 17 21 24 28 33 37 40 44 49 57 60 65
0 4 9 12 16 20 24 28 32 37 40 44 52 56 60 64
0 4 9 12 16 21 24 29 33 37 40 44 50 56 60 64
0 4 9 12 16 20 24 28 33 37 40 44 50 57 60 65
0 4 9 12 16 20 25 29 33 37 40 44 50 57 60 64
0 4 9 12 16 21 25 29 33 36 40 45 48 57 60 65
1 4 8 13 17 20 24 29 33 37 40 44 49 57 60 64
1 4 8 13 16 20 24 29 33 37 40 44 50 57 60 64
0 5 9 12 17 20 25 28 33 37 40 44 49 57 60 65
1 4 8 13 16 20 24 29 33 37 40 44 49 57 60 65
1 4 9 12 17 20 24 28 32 37 41 44 52 56 60 64
1 4 8 13 16 20 25 29 33 37 40 44 50 57 60 65
0 4 9 12 16 20 24 28 32 37 40 44 48 56 60 64
0 5 9 12 17 20 24 28 33 37 40 44 49 57 60 64 32
