1 2 4 7 8 10 13 15 17 19 20 22 26 30 32 35
1 2 4 7 8 10 12 15 17 19 20 22 26 31 32 35
0 2 5 6 8 11 13 15 17 18 20 23 24 31 32 34
1 2 4 7 8 10 13 15 17 19 20 22 26 30 32 35
1 2 4 7 8 10 13 15 17 19 20 22 26 31 32 35
1 2 4 7 8 10 12 15 17 19 20 22 26 31 32 35
1 2 4 7 8 10 12 15 17 19 20 22 26 31 33 35
0 2 5 6 8 11 12 15 17 18 20 23 24 31 33 34
0 2 5 6 8 11 13 15 17 18 20 23 24 31 32 34
1 2 4 7 8 10 12 15 17 19 20 22 26 30 33 34
1 2 4 7 8 10 13 15 17 19 20 22 26 31 32 35
0 3 5 6 9 10 12 14 17 19 20 22 25 31 33 34
0 2 5 6 8 11 13 15 17 18 20 23 24 31 32 34
0 2 5 6 8 10 13 14 16 18 20 22 24 30 32 34
0 2 5 6 8 11 13 14 16 18 20 22 26 30 32 34
0 2 5 6 8 11 13 14 16 18 20 22 28 30 32 34
0 3 5 6 9 10 13 14 17 19 20 22 25 31 32 34
1 2 4 7 8 10 12 15 17 19 20 22 26 31 32 35
0 2 5 6 8 11 13 15 17 18 20 23 24 31 32 35
0 2 4 7 8 11 13 15 17 19 20 23 24 31 32 35
0 3 5 6 9 10 12 14 17 19 20 22 25 31 33 34
0 3 5 6 9 11 12 14 17 19 20 22 25 31 32 34
1 2 4 7 8 10 12 15 17 19 20 22 26 31 32 35
0 3 5 6 9 10 12 14 17 19 20 22 25 31 32 35
0 2 5 6 8 10 12 14 16 19 20 22 28 30 32 34
0 2 5 6 8 11 13 15 17 19 20 22 26 30 32 34
0 2 5 6 8 11 13 15 17 19 21 22 26 30 32 34
1 2 4 7 9 10 12 15 17 19 20 22 25 31 32 34
1 2 4 7 8 10 12 15 17 19 20 22 26 31 32 35
1 2 4 7 8 10 13 15 17 19 20 22 25 30 33 35
0 2 5 6 9 10 12 14 16 19 20 22 28 30 32 34
1 2 4 7 8 10 12 15 17 19 20 22 26 31 33 35
1 2 4 7 8 10 12 15 17 19 20 22 25 30 32 35
0 3 5 6 9 11 13 14 17 19 20 22 25 31 32 34
0 2 5 6 8 11 12 15 17 18 20 23 24 31 32 34
1 2 4 7 8 10 12 15 17 19 20 22 26 31 33 34
1 2 4 7 8 10 12 15 17 19 20 22 26 31 32 34
0 3 5 6 9 10 13 14 17 19 20 22 25 31 32 34
0 2 5 6 8 11 13 15 17 18 20 23 24 31 32 34
1 2 5 6 9 10 12 14 16 19 21 22 28 30 33 34
1 2 5 6 9 10 12 14 16 19 20 22 28 30 32 34
0 3 5 6 8 10 13 14 17 19 20 22 25 31 32 34
0 2 5 6 9 10 13 14 16 19 20 22 28 30 32 34
0 3 5 6 9 10 12 14 17 19 20 22 25 31 32 34
1 2 4 7 8 10 13 15 17 19 20 22 26 31 32 35
1 2 4 7 8 10 13 15 17 19 20 22 26 31 32 35
0 2 5 6 8 11 13 14 16 18 20 22 28 30 32 34
1 2 4 7 8 10 13 15 17 19 20 22 26 31 32 35
1 2 4 7 8 11 13 15 17 19 20 22 26 31 32 35
1 2 4 7 8 10 13 15 17 19 20 22 26 31 32 34
1 2 4 7 8 10 13 15 17 19 20 22 26 31 32 35
1 2 5 6 9 10 12 14 16 19 20 22 28 30 32 34
0 2 5 6 8 11 13 15 17 19 20 22 26 31 32 34
0 2 5 6 8 11 13 14 16 18 20 22 29 30 32 35
1 2 4 7 8 10 13 15 17 19 20 22 26 31 32 34
1 2 4 7 8 10 12 15 17 19 20 22 26 31 32 35
0 3 5 6 8 10 12 14 17 19 20 22 25 31 32 35
0 3 5 6 9 10 12 14 17 19 20 22 25 31 33 34
0 3 5 6 8 11 13 14 17 19 20 22 25 31 32 35
0 3 5 6 9 10 12 14 17 19 20 22 25 31 32 34
0 2 5 6 8 11 13 15 17 18 20 23 24 31 32 35
0 2 5 6 8 11 13 15 17 18 20 23 24 31 32 34
0 2 5 6 8 10 13 15 17 19 21 22 24 31 32 34
1 2 5 7 8 11 13 14 17 19 20 22 26 31 32 35
1 2 4 7 8 10 13 15 17 19 20 22 26 31 32 35
1 2 4 7 8 10 12 15 17 19 20 22 26 31 33 35
0 2 4 7 8 11 13 15 17 19 20 23 24 31 32 35
1 2 4 7 8 10 13 15 17 19 20 22 26 31 32 35
1 2 4 7 8 10 13 15 17 19 20 22 26 31 33 35
1 2 4 7 8 10 13 15 17 19 20 22 26 31 32 35
1 2 4 7 8 10 12 15 17 19 20 22 26 31 33 35
0 3 5 6 8 10 13 14 17 19 20 22 25 31 32 35
0 2 4 6 8 10 13 14 16 19 21 22 29 31 32 34
0 2 5 6 8 11 12 15 17 18 20 23 24 31 32 34
1 2 4 7 8 11 13 15 17 19 20 23 24 30 32 35
1 2 4 7 8 11 13 15 17 19 20 23 25 31 32 35
0 2 4 6 8 11 13 15 17 18 21 22 24 31 32 34
0 2 5 6 8 11 13 14 16 18 21 22 24 30 32 34
0 3 5 6 9 11 13 14 17 19 20 22 25 31 32 34
0 3 5 6 9 11 13 14 17 19 20 22 25 31 32 34
0 2 5 6 8 10 13 15 17 19 20 22 24 31 32 34
0 2 5 6 8 10 12 14 16 19 20 22 24 30 32 34
0 2 5 6 8 11 12 15 17 18 20 23 24 31 32 34
0 3 5 6 9 10 12 14 17 19 20 22 25 31 32 34
1 2 4 7 8 10 12 15 17 19 20 22 25 31 32 34
0 2 5 6 8 11 13 14 16 18 20 22 27 30 32 34
0 2 5 6 8 11 13 15 17 18 21 23 24 31 32 35
0 3 5 6 9 11 12 14 17 19 20 22 25 31 32 35
0 2 5 6 8 10 12 14 16 19 20 22 28 30 32 34
0 2 5 6 8 11 12 15 17 19 20 22 26 30 32 34
0 2 5 6 8 10 12 14 17 19 20 22 26 31 32 35
0 2 5 6 8 10 13 15 17 19 20 22 26 31 32 34
0 2 5 6 8 11 13 15 17 18 20 23 24 31 32 35
1 2 4 7 9 10 12 15 17 19 20 22 25 31 32 34
1 2 4 7 8 10 12 15 17 19 20 22 26 31 32 34
0 3 5 6 9 10 13 14 17 19 20 22 25 31 32 35
1 2 4 7 8 10 12 15 17 19 20 22 25 31 32 35
1 2 5 6 9 10 12 14 16 19 21 22 28 30 32 34
1 2 4 7 8 10 13 15 17 19 20 22 26 31 32 35
0 2 5 6 8 10 12 14 16 19 20 22 24 30 32 34
0 3 5 6 9 10 12 14 17 19 20 22 25 31 32 34 0